login = loginServlet
registration = RegisterServlet
resetPassword = resetPasswordServlet
error = Error.html
homepage = homepage.jsp
registerPage = RegisterForm.jsp
registerSuccess = RegisterSucess.html
productPage = ProductPage.jsp
cartCompletion = CartCompletion.jsp
    = viewHomePageServlet
viewHomePage = viewHomePageServlet
viewAllProduct = viewProuctPageServlet
productDetails = ProductDetails.jsp
viewProductDetails = viewProductDetailsServlet
custOrderList = ViewOrderListServlet
viewCart = CartDetails.jsp
cartContact = loadCartContactServlet
cartCompletion = CartCompletion.jsp
blogDetails = BlogDetails.jsp
viewBlogDetails = ViewBlogDetailServlet
blogList = BlogList.jsp
searchProduct = searchProductCustomerServlet
removeFromCart = removeFromCartServlet
logout = LogoutServlet
addToCart = addToCartServlet
userlist = userlist.jsp
userlistedit = userlistedit.jsp
mktCustDetails = viewCustomerDetailsServlet
mktProductList = viewProductMarketingServlet
mktProdDetails = viewProductDetailsMarketingServlet
mktPostDetails = viewPostDetailsMarketingServlet
mktFeedbackDetails = viewFeedbackDetailsMarketingServlet
mktSliderDetails = viewSliderDetailsMarketingServlet
mktSliderList = viewSliderListMarketingServlet
mktCustomerList = viewCustomerListServlet
mktPostList = viewPostListMarketingServlet
mktDashboard = MarketingDashboard.jsp
viewBlogList = ViewBlogListServlet
custFeedback = customerLoadFeedbackFormServlet
modifyQuantityCart = modifyQuantityCartServlet
mktFeedbackList = viewFeedbackListMarketingServlet
submitFeedback = submitFeedbackServlet
createUser = addUserServlet
updateFeedback = updateFeedbackServlet
removeSliderProd = removeSliderProductMarketingServlet
updateSlider = updateSliderMarketingServlet
addProdSlider = addProductSliderMarketingServlet
updateProd = updateProductServlet
updatePost = updatePostMarketingServlet
updateCust = updateCustomerServlet
checkout = CheckOutServlet
viewBlogByCate = ViewBlogByCategoryServlet
reqResetLink = requestResetLinkServlet
resetPwd = resetNewPasswordServlet
resetPage = resetPassword.jsp
custOrderDetail = ViewOrderDetailServlet
viewUserList = viewUserListPageServlet
viewUserDetails = viewUserDetailsPageServlet
viewAdminDashboard = viewAdminDashboardServlet
changeAdminGraph = changeAdminGraphServlet
AdminDashboard = AdminDashboard.jsp
updateProfile = updateUserProfileServlet
viewProdByCate = viewProductByCategoryServlet
changePass = changePasswordServlet
updateUserDetails = updateUserDetailsServlet
viewSManagerDashboard = viewSManagerDashboardServlet
changeSaleGraph = changeSaleGraphServlet
SaleManagerDashboard = SaleManagerDashboard.jsp
feedbackPage = CustomerFeedback.jsp
SaleManagerViewOrderList = SaleManagerViewOrderListServlet
SaleOrderDetails = SaleOrderDetails.jsp
saleOrderDet = SaleOrderDetailsServlet
SaleMemberDashboard = SaleMemberDashboard.jsp
ViewSMemberDashboard = ViewSMemberDashboardServlet
ViewSaleOrderList = ViewSaleOrderListServlet
SaleUpdateOrder = SaleUpdateOrderServlet
updateAvatar = updateAvatarServlet
